11 11
1 1 1 1 1 1 1 1 1 1 1
1 6 1 6 1 5 1 6 1 6 1
1 6 1 6 1 6 1 6 1 6 1
1 6 1 6 1 5 1 6 1 6 1
1 6 1 6 1 6 1 6 1 6 1
1 6 1 6 1 5 1 6 1 6 1
1 6 1 6 1 6 1 6 1 6 1
1 6 1 6 1 5 1 6 1 6 1
1 6 1 6 1 6 1 6 1 6 1
1 6 1 6 1 6 1 6 1 6 1
1 1 1 1 6 7 6 1 1 1 1
