11 11
1 1 1 1 1 1 1 1 1 1 1
1 6 1 6 1 6 1 6 1 6 1
1 6 1 6 1 6 1 5 5 5 1
1 1 1 6 1 5 1 3 3 3 1
5 6 3 3 1 6 1 4 4 4 6
1 6 3 3 5 5 1 6 1 6 6
1 6 1 6 1 6 1 1 1 1 1
1 6 1 6 6 5 1 3 3 3 1
1 4 4 1 1 6 1 3 3 6 5
1 6 1 1 6 6 6 6 1 6 6
1 1 1 1 6 7 6 1 1 1 1
